##################################################
#P......................#............#...........E#
#..#...................#............#............#
#..#...............#####............#######......#
#..#..............#................#.......#.....#
#..#..............#................#.......#.....#
#..#..............#................#.......#.....#
#..#..............#................#.......#.....#
#..################................#.......#.....#
##################################################
